111111111111111111111111111111111111111111111111111111111111111111111111111111111111111111111111111
1A0000000110000010000011111100000000111111000000111111111110000000000000000000001100000000000000001
100000000011001001001001111110000000001111100000011111111111000000000010000000000100000000000000001
111100110011001001001001000000011111000111100111111111111111000000000100000000000100000000000000001
111100110011001001001001000000011111100011100000000000000111000000001000100000000100000000000000001
111100110011001001001001111110011111110001100000000000000111000000010000001000010001000000000000001
111100110011001001001000000000011111111000000111111111100111000000100000000010100000100000000000001
111100110000001000001000000000011111111000000111111111100111000001000000000000000000011000000000001
111100111111111111111111111110011111110001100111111111100000000001001100000000000000001000000000001
1B0000000000000000000000000010011111100011100111111111000000000001000000000000000000000000000000001
000000000000000000000000000010010011000111100111111110001111000000000000000001100000001000000000001
111111111111111111111111100110010010001111100111111100011111000000000000000000000000010000000000001
111111111111111000000000000110010000011111100111111000111111000001111111111110010000000000000000001
111111111111111000000000000110010011111111100111110001111111000000000000001100001000000000000000001
100000000000000001111111111110000000000000000111100011111111000000000000100000000010000100000000001
10C000000000000001111111111110000000000000011111000111111111000000110000000001010001100000000100001
111111111111111000000000000010011111111110000000001111111111000000000110000000001000000000001000001
111111111111111000000000000010010000000000000000011111111111000010001000100000100000100000010001001
111111111111111111111111111110010000000000011110000000011111000000000000000001000011000010000100001
100000000000001111111111111110010011111111111110000000011111000001011010001000000000010001000000001
10D000000000001100000000011110010000000000001111111110000000000000000000000000101100000000000000001
111111001111001100000010000010010000000000001111111110000000000000100001000000000100100000100000001
111110000000001100000010000010000011111110000000000000011111000000000000100000000000000110000000001
111110000000001100000010011110000011111110000000000000011111000000001000011000010000000000100000001
111110011111000000111111111110011111111110011111111111111111000000000010000000111001000000000000001
111110011111000000111111111110010000000110000000000000000001000000000010100001000000000000000000001
111110011111111100111111111110010000000110000000000000000001000000000001000001000100011000000011001
111110000000000000111111111110011001100110000001111111111000000000000000010000000010000000100000001
111110000000000000111111111110000001100110000000000111111000000000001110000100010101001010000000001
100000011100111001111111111110000001100000011000000000000001000000000000000000010000000000000000001
100000011000000000000000000000011111100000011111100000000001000000000000000000010000000000000000001
111111111000000000000000000000011111111111111111111111111111111111111111111111111111111111111111111
