1111111111111111111111111111111111111111111111111111111111111111111111111111111111111111111111111111111111111111111111111111111111111111111111111111111111111111111111111111111111111111111111111111111
1000000001100000100000111111000000001111110000001111111111100000000000000000000011000000000000000000000000000000000000000000000100010000000000000000000000000000000000110111111011100000000000000110009
1000000000110010010010011111100000000011111000000111111111110000000000100000000001000000000000000011111111111111111111111111010101010111111111111111111111111011111111110111011011101111111111110110111
1111001100110010010010010000000111110001111001111111111111110000000001000000000001000000000000000011111000100000111111111111010101010100000000000000000000010011101111110000000000001100000000000110111
1111001100110010010010010000000111111000111000000000000001110000000010001000000001000000000000000011111010101110000000000001010101010101011111111111111100100111000000000111101111111101111111110110111
1111001100110010010010011111100111111100011000000000000001110000000100000010000100010000000000000011111010101000111111111111010101010101011011111110111001001111111111110111100011101100000000010110111
1111001100110010010010000000000111111110000001111111111001110000001000000000101000001000000000000011111010101011111111111111010101010101010011111110010010011000000000000111001111101111111101010110111
1111001100000010000010000000000111111110000001111111111001110000010000000000000000000110000000000000000010001000000000000000010101010101011100000001100100111001111111111111111111101111111101010110111
1111001111111111111111111111100111111100011001111111111000020000010011000000000000000010000000000011111111111111111111111111010101010101011110000011001001111001000000000000000001101111111101010110111
1000000000000000000000000000100111111000111001111111110000030000010000000000000000000000000000000000000000011000000000000001010101010101011111111110010011111000011101111011111101100000000001010110111
0000000000000000000000000000100100110001111001111111100011110000000000000000011000000010000000000011111111110001011111111011010101010101011111111100100111111111111101111010000000111111111111010110111
1111111111111111111111111001100100100011111001111111000111110000000000000000000000000100000000000000000001100101011111110111010101010101011111111001001000000000000000000011011110100000000000010110111
1111111111111110000000000001100100000111111001111110001111110000011111111111100100000000000000000010111111000101000000000000010101010101011111111100011011111111111111111011011110101111111111111110111
1111111111111110000000000001100100111111111001111100011111110000000000000011000010000000000000000010111110010101111111111111010101010101011111111100111000000000000000001000000010100000000000000000001
1000000000000000011111111111100000000000000001111000111111110000000000001000000000100001000000000010111100110100000000000001010101010101011111111001111111111111111111101011111010101111111111111110111
1000000000000000011111111111100000000000000111110001111111110000001100000000010100011000000001000010111001110101111111111111010101010101011111110011111000000000000000101011111010100000001111011110009
1111111111111110000000000000000111111111100000000011111111110000000001100000000010000000000010000010110011110100000000000111010101010101011111100111111000000000000000101110000010111111101000000000111
1111111111111110000000000000000100000000000000000111111111110000100010001000001000001000000100010011100111110111111111110111010101010101000000000111100000000000000000101110111110100000001111111110111
1111111111111111111111111111100100000000000111100000000111110000000000000000010000110000100001000011001111110000000000010111010101010101011111111111100000000000000000101000111000001111100000000000111
1000000000000011111111111111100100111111111111100000000111110000010110100010000000000100010000000010011111111111111111010111010101010101000000000000001000000000000000101011111111111011101101111111111
1000000000000011000000000111100100000000000011111111100000040000000000000000001011000000000000000000000000000000000011010111010101010101111111111111111000000000000000101000000000000011111101000000111
1111110011110011000000100000100100000000000011111111100000050000001000010000000001001000001000000011111111111111100111010111010101010101100111111111111000000000000000101101111111111110111101111110111
1111100000000011000000100000100000111111100000000000000111110000000000001000000000000001100000000000000100000001001100010111010101010101000000000111111000000000000000101101000001110110111100000000001
1111100000000011000000100111100000111111100000000000000111110000000010000110000100000000001000000011110101111110011101010111010101010101110101001111111111000000000000101101111101000110000001111111111
1111100111110000001111111111100111111111100111111111111111110000000000100000001110010000000000000011110101111100111101010111010101010100000000000000000001000000000000101100000001110110111101111111111
1111100111110000001111111111100100000001100000000000000000010000000000101000010000000000000000000011110101111001111101010111010101010111111111111111111101000000000000101111111101110111111101111111111
1111100111111111001111111111100100000001100000000000000000010000000000010000010001000110000000110000000100000011111101010111010101010100000000000000000001000000000000101011111101110111111111111111111
1111100A60000000001111111111100110011001100000011111111110060000000000000100000000100000001000000000111101111111111101010111010101010101111111111111111111000000000000101000000001110000000000000000001
1111100000000000000111111111110000001100110000000001111110000000000011100001000101010010100000000010000000000000000001010111010001000100000000000000000001000000000000101101111111000101111111111101111
1000D60111001110011111111111100000011000000110000000000000010000000000000000000100000000000000000010111111111111111111010111011111110111111111111111111101000000000000101101111111110101111111111111111
10B6000110000C60000000000000000111111000000111111000000000010000000000000000000100000000000000000000111111111111111111000111000000000000000000000000000001000000000000001100000000000100000000000000009
1111111111111111111111111111111111111111111111111111111111111111111111111111111111111111111111111111111111111111111111111111111111111111111111111111111111111111111111111111111111111111111111111111111
